20 15
0 50
6 0 0 0 0 0 0 0 0 0 0 0 0 0 0 0 0 0 0 0
0 4 4 4 4 4 4 4 0 0 7 0 0 0 0 0 0 0 0 0
5 0 0 0 0 0 0 4 0 0 0 0 0 6 0 0 0 0 0 0
0 0 0 0 0 5 0 4 0 5 0 0 0 0 0 0 5 0 0 0
0 0 7 0 0 0 0 4 0 0 0 0 0 0 0 0 0 0 0 0
0 0 0 5 0 0 0 4 4 4 4 4 4 4 4 4 4 0 0 0
0 5 0 0 0 0 0 4 0 0 0 0 0 0 0 0 0 0 0 0
0 0 0 0 7 0 0 4 0 6 0 6 0 0 0 0 0 0 0 0
0 0 0 0 0 0 0 4 0 0 0 0 0 0 0 0 0 0 0 0
4 4 4 4 4 4 4 4 4 4 4 4 4 4 4 4 4 4 4 4
4 4 3 3 3 3 3 3 3 3 3 3 3 3 3 3 3 3 4 4
4 4 1 1 1 1 1 1 1 1 1 1 1 1 1 1 1 1 4 4
4 4 1 1 1 1 1 1 1 1 1 1 1 1 1 1 1 1 1 4
4 4 1 1 1 1 1 1 1 1 1 1 1 1 1 1 1 1 1 1
4 4 1 1 1 1 1 1 1 1 1 1 1 1 1 1 1 1 1 1