20 15
975 297
4 4 4 0 0 0 0 0 6 0 0 0 0 0 0 0 0 0 0 0
4 4 4 0 0 0 0 0 0 0 0 0 0 0 0 0 5 0 0 0
0 4 4 0 0 0 7 0 0 0 0 6 5 0 0 0 0 0 0 0 
0 4 4 0 0 0 0 0 0 0 0 0 0 0 0 0 0 0 0 0
0 4 4 0 0 0 0 0 0 0 0 0 0 0 0 0 0 0 0 0
0 4 4 4 4 4 4 4 4 4 4 4 4 4 4 4 4 0 0 0
0 4 4 0 0 0 0 0 0 0 0 0 5 0 0 0 0 0 0 0
0 4 4 5 0 0 0 0 0 0 0 0 0 0 0 5 0 0 0 0
0 4 4 0 0 0 0 0 7 0 0 6 0 0 0 0 0 0 0 0
0 4 4 0 0 0 0 0 0 0 0 0 0 0 0 0 0 0 0 0
0 4 4 0 0 0 0 0 0 5 0 0 0 0 0 0 0 0 0 0
3 3 3 3 3 3 3 3 3 3 3 3 3 3 3 3 3 3 3 3
1 1 1 1 1 1 1 1 1 1 1 1 1 1 1 1 1 1 1 1
1 1 1 1 1 1 1 1 1 1 1 1 1 1 1 1 1 1 1 1
1 1 1 1 1 1 1 1 1 1 1 1 1 1 1 1 1 1 1 1