20 20
1 1278
0 0 0 0 0 0 0 0 0 0 0 0 0 0 0 0 0 0 0 0
0 0 0 0 0 0 0 0 6 0 0 0 0 0 0 0 0 0 0 0
5 0 0 0 0 0 0 0 0 0 0 6 0 0 0 0 0 0 0 0
0 0 0 0 0 5 0 0 0 5 0 0 0 0 0 0 0 0 0 0
0 0 0 0 0 0 0 0 0 0 0 0 0 0 0 0 0 0 0 0
4 4 4 4 4 4 4 4 4 4 4 4 4 4 4 0 0 0 0 0
4 4 0 0 0 0 0 0 0 0 0 0 0 0 0 0 0 0 0 0
4 4 0 0 5 0 0 0 0 6 0 0 0 0 0 0 0 0 0 0
4 4 0 0 0 0 0 0 0 0 0 0 0 0 0 0 0 0 0 0
4 4 0 0 0 0 0 0 0 0 0 6 0 0 0 0 5 0 0 0
4 4 0 0 0 0 0 0 6 0 0 0 0 0 0 0 6 0 0 0
4 4 0 0 0 0 0 0 0 0 0 0 0 0 0 0 0 0 0 0
4 4 6 0 0 0 5 0 0 0 0 0 0 0 0 0 0 0 0 0
4 4 0 0 0 0 0 0 0 0 0 0 0 0 0 0 0 0 0 0
4 4 4 4 4 4 4 4 4 4 4 4 4 4 4 4 4 4 4 4
4 4 3 3 3 3 3 3 3 3 3 3 3 3 3 3 3 3 3 3
4 4 1 1 1 1 1 1 1 1 1 1 1 1 1 1 1 1 1 1
4 4 1 1 1 1 1 1 1 1 1 1 1 1 1 1 1 1 1 1
4 4 1 1 1 1 1 1 1 1 1 1 1 1 1 1 1 1 1 1
4 4 1 1 1 1 1 1 1 1 1 1 1 1 1 1 1 1 1 1